border_size=1
usage=map

Gg          , Gg          , Gg          , Gg          , Gg          , Gg          , Gg          , Gg          , Gg          , Gg          , Gg          , Gg          , Gg          , Gg          , Gg          , Gg          , Hh          , Hh          , Hh          , Gg          , Hh          , Gg          
Gg          , Gg          , Gg          , Gg          , Gg          , Gg          , Gg          , Gg          , Gg          , Gg          , Gg          , Gg          , Gg          , Gg          , Gg          , Gg          , Ss          , Hh          , Gg          , Hh          , Hh          , Hh          
Gg          , Gg          , Gg          , Gg          , Ss          , Gg          , Ss          , Gg          , Gs^Fp       , Gg          , Gg          , Gg          , Gg          , Gg          , 4 Ke        , Gg          , Ss          , Ss          , Ss          , Hh^Vhh      , Hh          , Gg          
Gg          , Gg          , Ss          , Ss          , Ss          , Ss          , Gg          , Gs^Fp       , Gs^Fp       , Gs^Fp       , Gg          , Gg          , Gg          , Ce          , Ce          , Ce          , Ss          , Ds          , Ss          , Ss          , Ss          , Gg          
Gg          , Gg          , Gg          , Gg          , Gg          , Gg          , Gg          , Gs^Fp       , Gs^Fp       , Gs^Fp       , Ss          , Ss          , Ss          , Ss          , Gg          , Gg          , Gg          , Ss          , Ss          , Gs^Fp       , Ss          , Gg          
Gg          , Ss          , Ce          , 3 Ke        , Ce          , Gg          , Gs^Efm      , Gg^Ve       , Gs^Fp       , Hh          , Hh          , Ss          , Gs^Fp       , Gs^Fp       , Ss          , Ss^Vhs      , Gs^Fp       , Ss          , Gs^Fp       , Gs^Fp       , Gg          , Gg          
Gg          , Ss          , Ss          , Ce          , Gg          , Gg          , Gg          , Gg          , Hh          , Hh          , Hh          , Gs^Fp       , Ww          , Gs^Fp       , Ww          , Gg          , Ss          , Gs^Fp       , Ss          , Gg          , Gs^Efm      , Gg          
Ss          , Ss          , Gg          , Gg          , Ss          , Gg          , Gg          , Gg          , Gg          , Hh          , Gg^Fet      , Hh          , Ww          , Gs^Fp       , Ww          , Ww          , Ss          , Ww          , Ww          , Ss          , Ss          , Gg          
Gg          , Gg          , Gs^Efm      , Gg          , Ss          , Gg          , Gg^Ve       , Ss          , Hh          , Hh          , Ww          , Ww          , Ww          , Ww          , Gg          , Gg          , Gs^Fp       , Ss          , Ww          , Ww          , Ww          , Ss          
Gg          , Hh          , Gg          , Gg          , Gg          , Gg          , Gs^Fp       , Ss          , Ss          , Ww          , Gg          , Ww          , Gg          , Gg          , Ss          , Gs^Fp       , Gs^Fp       , Gs^Fp       , Ss          , Ss          , Wo          , Wo          
Gg          , Gg          , Ww          , Ww          , Ww          , Ww          , Ww          , Ww          , Ww          , Gg          , Ss          , Gg          , Ss          , Ss          , Chr         , Ss          , Ss          , Ss          , Wo          , Wo          , Ss          , Gg          
Wo          , Ww          , Wo          , Wo          , Wo          , Wo          , Wo          , Gs^Fp       , Ss          , Wo          , Ss          , Ss          , Gg          , Ss          , Wo          , Chr         , Ww          , Ww          , Wo          , Ww          , Ss          , Ss          
Wo          , Wo          , Ww          , Ww          , Ww          , Ww          , Ww          , Gg          , Ss          , Ww          , Wo          , Wo          , Wo          , Wo          , Ww          , Wo          , Wo          , Wo          , Ww          , Hh          , Hh          , Gg          
Gg          , Gg          , Ww          , Gg          , Ss          , Gg          , Ss          , Ss          , Gg          , Gg^Vh       , Gg          , Ww          , Gs^Fp       , Gs^Fp       , Ww          , Gg          , Ww          , Ww          , Gg          , Hh          , Hh          , Hh          
Gg          , Gg          , 1 Gg        , Gg          , Gg          , Gg          , Ss          , Ss          , Ss          , Gs^Efm      , Ss          , Ww          , Gg          , Ww          , Gs^Efm      , Gg          , Gg          , Gg          , Gg          , Hh          , Hh          , Gg          
Ss          , Ss          , Gg          , Ss          , Gs^Fp       , Gs^Fp       , Gs^Fp       , Ss          , Re^Gvs      , Re^Gvs      , Re^Gvs      , Ss          , Ss          , Gs^Efm      , Gg          , Gg          , Ss          , Gg          , Gg          , Hh          , Hh          , Gg          
Gg          , Ss          , Ss          , Ss          , Gs^Fp       , Gs^Fp       , Re^Gvs      , Re^Gvs      , Re^Gvs      , Re^Gvs      , Re^Gvs      , Ss          , Gs^Efm      , Gg^Vh       , Ss          , Ss          , Ss          , Gg^Ve       , Gs^Fp       , Gs^Fp       , Gs^Fp       , Gg          
Gg          , Gg          , Gg          , Ss          , Ss          , Ss          , Re^Gvs      , Re^Gvs      , Re^Gvs      , Re^Gvs      , Gs^Efm      , Gs^Efm      , Ch          , Ss          , Gs^Efm      , Gs^Efm      , Gs^Efm      , Gg          , Ss          , Gs^Fp       , Rp          , Rp          
Gg          , Gg          , Ss          , Gg^Wm       , Re^Gvs      , Re^Gvs      , Re^Gvs      , Re^Gvs      , Ss          , Ss          , Ss          , Ch          , 2 Kh        , Gg          , Gs^Efm      , Gs^Efm      , Gs^Efm      , Ss          , Rp          , Rp          , Re^Gvs      , Re^Gvs      
Gg          , Gg^Ve       , Re^Gvs      , Re^Gvs      , Re^Gvs      , Re^Gvs      , Re^Gvs      , Ss          , Ss          , Ss          , Gs^Efm      , Gg          , Gg          , Ch          , Rp          , Gs^Efm      , Rp          , Rp          , Re^Gvs      , Re^Gvs      , Re^Gvs      , Re^Gvs      
Re^Gvs      , Re^Gvs      , Re^Gvs      , Re^Gvs      , Re^Gvs      , Re^Gvs      , Gg          , Gg          , Ss          , Gs^Efm      , Gs^Efm      , Gg          , Gs^Efm      , Rp          , Rp          , Rp          , Ss          , Re^Gvs      , Re^Gvs      , Re^Gvs      , Re^Gvs      , Re^Gvs      
Re^Gvs      , Re^Gvs      , Re^Gvs      , Re^Gvs      , Gg          , Gg          , Gg          , Gg          , Gg          , Gg          , Gg          , Gs^Efm      , Rp          , Rp          , Gg          , Ss          , Gg          , Re^Gvs      , Re^Gvs      , Re^Gvs      , Re^Gvs      , Re^Gvs      
